-- наружный боковый придаток растения

строеніе
    эпидермис == надкожица кожица -- наружный слой кожи
    мезофи́лл == паренхи́ма -- внутренняя хлорофиллоносная ткань, выполняющая основную функцию — фотосинтез.
    сеть жи́лок -- образованных проводящими пучками (проводящая ткань), состоящими из сосудов и ситовидных трубок, для перемещения воды, растворённых солей, сахаров и механических элементов.
    у́стьица -- клетки на нижней поверхности листьев; через них происходит испарение лишней воды (транспирация) и газообмен
жилкование
    сетчатое
        перистонервное
        радиальное
        пальчатое
    параллельное
    дихотомическое
разделение листовых пластинок
    простой -- из единственной листовой пластинки и одного черешка
    сложный -- из нескольких листочков, расположенных на общем черешке (рахис)
        пальчатые == лапчатые --все листовые пластинки расходятся по радиусу от окончания корешка подобно пальцам руки. главный черешок листа отсутствует - конопля, конский каштан
        перистые -- пластинки расположены вдоль основного черешка
            непарноперистые -- с верхушечной листовой пластинкой - ясень
            парноперистые -- без верхушечной пластинки - из рода swietenia
        двуперистые -- листья разделены дважды: пластинки расположены вдоль вторичных черешков, которые в свою очередь прикреплены к главному черешку - альбиция
        трёхлистные -- имеется только три пластинки - клевер бобовник
        перистонадрезные -- как перистые, но пластинки у них не полностью разделены - некоторые рябины
виды
    колючки -- заострённые твёрдые одревесневшие образования
        листовая пластинка == одревесневшие жилки - барбарис
        превращаються в прилистники - акация
    ловчие -- служащие ловчими органами хищных растений
    мешковидные -- от срастания краёв листа вдоль средней жилки таким образом, что получается мешок с отверстием наверху - лиана dischidia major
    прицветник == кроющий лист -- листья в пазухах которых располагаются цветки или соцветия
    суккулентные -- листья для запасания воды - алоэ агава
    усики -- образуются из верхних частей листьев как опора цепляться за окружающие предметы - чина горох
    филлодии -- черешки, приобретающие листовидную форму, осуществляющие фотосинтез. настоящие листочки редуцируются
    хвоя == глиця -- листоподобные органы голосеменных (хвойных)
    шипы == эмергенцы -- выросты на поверхности кожицы растений, покрывающие черешки листьев и молодые побеги у розы, малины, ежевики, волоски хмеля, шипы на плодах многих зонтичных, каштана конского, дурмана
    трихомы == волоски -- клетки кожицы или выросты, образующие опушение на поверхностных органах растений
расположеніе
    розетка -- листья, растущие из одной точки в разные стороны, все листья находятся на одной высоте и расположены по кругу - камнеломка, хлорофитум, агава
    очерёдное == последовательное -- располагаются по одному (в очередь) на каждый узел - берёза, яблоня, роза, традесканция, циссус, пеларгония
    супроти́вное -- располагаются по два на каждом узле и обычно перекрёстно-попарно, то есть каждый последующий узел на стебле повёрнут относительно предыдущего на угол 90°; либо двумя рядами, без поворота узлов - сирень, яснотка, мята, жасмин, фуксия
    муто́вчатое -- располагаются по три и более на каждом узле стебля (мутовке) - элодея, вороний глаз, олеандр


лепесток == пелюстка
прили́стники -- парные придатки в нижней части листа, расположенные по обеим сторонам черешка, придаток на каждой стороне основания черешка и напоминает маленький листик
черешок -- небольшой стебель к которому крепятся листья, суженная часть листа, соединяющая листовую пластинку со стеблем
