== пагон -- вегетативный член высших растений, состоящий из стебля + листья почки плоды цветки

подземный
    каудекс -- у многолетних трав и полукустарничков с хорошо развитым стержневым корнем, сохраняющимся в течение всей жизни растения. вместе с корнем он служит местом отложения запасных веществ и несёт на себе множество почек возобновления, часть которых могут быть спящими - бедренец ферула люцерна люпин одуванчик полынь, василёк шероховатый
    подземный столон -- однолетний удлинённый тонкий подземный побег с недоразвитыми чешуевидными листьями. на утолщённых концах столонов растения могут накапливать запасные вещества, образуя клубни или луковицы - картофель, седмичник, адокса
    стеблевой клубень -- с ярко выраженной запасающей функцией стебля, наличием чешуевидных листьев, которые быстро сшелушиваются, и почек, формирующихся в пазухах листьев и называемых глазками - картофель, топинамбур
    бульба -- луковица цветочного растения
    корневище -- подземный побег  многолетних трав с чешуевидными, недоразвитыми или рано отмирающими листьями, верхушечными или пазушными почками, придаточными корнями, отличается от корня наличием почек?
    корнеклубень == бульбокорінь, корневая шишка -- боковой или придаточной корень, в котором откладываются запасающие вещества
    корнеплод -- часть растения, запасающая питательные вещества -- капустные (репа, редька, брюква, турнепс) зонтичные (морковь, петрушка, сельдерей, пастернак) маревые (свёкла) астровые (цикорий, скорцонера) однолетние (редис) многолетние (катран)
    луковица -- утолщенная нижняя часть стебля некоторых растений
    псевдобульба == ложная луковица, надземный воздушный клубень -- утолщённая околоземная часть стебля у представителей семейства орхидных
    клубнелуковица == бульбоцибулина -- подземный укороченный видоизменённый побег; сильно утолщённая подземная часть стебля -- аноматеку (anomatheca), ацидантеру (acidanthera), бабиану (babiana), бродиэю (brodiaea), безвременник (colchicum), гладиолус (gladiolus), гомерию (homeria), диераму (dierama), иксию (ixia), кандык (erythronium), крокосмию (crocosmia), мерендеру (merendera), морею (moraea), ромулею (romulea), спараксис (sparaxis), текофилею (tecophilaea), тульбагию (tulbaghia), уотсонию (watsonia), фрезию (freesia), шафран (crocus)
    корни-зацепки — своеобразные придаточные корни. при помощи этих корней растение «приклеивается» к любой опоре.
    ходульные — отходящие от ствола под углом придаточные корни, которые достигнув грунта, врастают в него
    досковидные -- боковые корни, проходящие у самой поверхности почвы или над ней, образующие треугольные вертикальные выросты, примыкающие к стволу, для крупных деревьев тропического дождевого леса.
    воздушные == дыхательные голокорникорни
    корни-подпорки == столбовидные -- придаточные, растущие на стволах и ветвях и дорастающие до земли
    грибокорень
    бактериальные клубеньки на корнях высших растений -- боковые корни, приспособленные к сожительству высших растений с азотфиксирующими бактериями

    коріень -- осевой, обычно подземный у высших сосудистых, осуществляет закрепление в почве и обеспечивает поглощение и проведение воды с растворёнными минеральными веществами к стеблю и листьям
        главный
        боковые
        придаточные -- отходящие от стебля или от листьев

        стержневой -- у двудольных, главный корень сильно развит и хорошо заметен среди других корней, глубокопроникающий
            ветвистый -- у деревьев, из нескольких боковых корней, среди которых не различают главный корень
        мочковатый -- у однодольных, оплетает прилегающие частицы почвы, на ранних этапах развития главный корень, образованный зародышевым корешком, отмирает, а корнестрой составляется придаточными корнями
надземный
    почка *
    кочан -- у культурной капусты. приспособительная форма кочана возникла как видоизменение части розетки.
    кладодий -- боковой побег, обладающий способностью к длительному росту, с зелёными плоскими длинными стеблями, выполняющими функции листа - мюленбекия плоскоцветочная, кактус-декабрист, кармихелия южная, коллеция, опунция
    филлокладий -- листовидно уплощённый боковой побег из боковых почек, обладающий ограниченным ростом листа - иглица, смела, спаржа, филлантус, филлокладус
    розеточные -- с сильно укороченными междоузлиями, в результате чего все листья располагаются в виде розетки. различают прикорневые розетки - подорожник циперус
    столоны и усы -- для вегетативного размножения как захват площади и расселения дочерних особей, симподий из надземных побегов вегетативного размножения возрастающего порядка - живучка ползучая
    колючка -- одревесневающий безлистный укороченный с острой верхушкой
        из укороченных побегов, имеющие ограниченный рост и оканчивающиеся остриём - яблони дикая, груша дикая, крушина слабительная
        на стволах из спящих почек - гледичия
        из пазушных почек листьев, что топографически соответствует боковым побегам - боярышник
    усик -- жгутовидный ветвистый или неразветвлённый лишённый листьев как опора - тыквенные виноград, страстоцвет голубой


кочерыга == кочерыжка -- твёрдый стебель кочана капусты
стебель == стебло -- удлинённый побег
узел -- участок оси побега растений (стебля), на котором образуются боковые органы (ветви, листья, почки, придаточные корни)
междоузлие == міжвузля -- участок стебля или побега между двумя смежными узлами
лоза -- подовжене гнучке стебло або гілка
ботва == гичка ботвина ботвиння бадилля -- стебли и листья корнеплодов и клубневых
раструб -- стебель, образующий прилистниками, срастающимися вокруг стебля наподобие футляра (гречишные)
черешок -- небольшой стебель , суженная часть листа , соединяющая листовую пластинку со стеблем
стеблекорень -- образование на границе стеблевой и корневой частей растения, представляющее собой одревесневшие нижние участки многолетних побегов с почками возобновления, соединённые с одревесневшим гипокотилем, нередко разросшимся и утолщённым, от которого отходит стержневой корень
черенок -- отрезок стебля, корня и листа растения, отделяемый для вегетативного размножения
хряпка -- капустная кочерыжка
репняк == ботва репы
шишка -- побег, развивающийся на концах веток голосеменных растений в виде маленьких образований, покрытых чешуйками
паростки -- пагони, що утворюються на дереві внаслідок проростання сплячих бруньок

мутовка == колотівка -- часть осевого органа растения (узел), стебля или ветви, на которой кольцеобразно, на одной высоте (уровне), располагается три и более органа, обычно листьев, цветков или ветвей
костра == кострика костеря кострица костриця терміття паздір паздір'я -- одревесневшие части стеблей прядильных растений, получаемые при мятье и трепании
соломина -- полый валовый стебель злаковых, в местах прикрепления листьев может образовывать вздутия
