
простыё -- у которых на главной оси расположены одиночные цветки и таким образом ветвление не превышает двух порядков
    серёжка -- длинная, повислая ось с цветоножками одинаковой длины - ива, тополь ольха берёза лещина
    кисть == китица - ландыш, барбарис
        гроздь == гроно -- кисть ягод или мелких плодов, а также скопление цветов в виде кисти - виноград
    колосок -- 	длинная ось с сидячими цветками - подорожник трезубец злаки ятрышник ослинник
    початок == начало, почин -- главная ось длинная утолщенная с сидячими цветками - кукуруза (маточковые цветы), кала болотная, белокрыльник, аир
    щиток -- главная ось удлиненная; благодаря значительной разнице в длине цветоножек, цветы расположены почти в одной горизонтальной плоскости - 	груша, боярышник
    тенник == зонт зонтик парасоля парасоль дощар дождник -- главная ось крайне укорочена, цветоножки почти одинаковой длины - чистотел, первоцвет, проломник, вишня
    головка -- ось укороченная, шаровидная или яйцевидная, иногда утолщенная, цветки сидячие - шелковица, хмель, клевер, люцерна, адокса
    корзина -- ось укороченная и расширенная, сидячие цветки плотно расположены на ее почти плоской поверхности - ноготки одуванчик ромашка сложноцветные
сложные
    волоть -- разветвленность боковых ветвей обычно возрастает к основанию и есть замість окремих квіток несуть прості або гіллясті китиці - синюха, бузина красная
    сложная парасолька -- боковые оси оканчиваются не цветками, а простыми зонтиками - морковь, укроп
    двойная кисть -- на удлинённой моноподиальной главной оси располагаются пазушные простые кисти - мотыльковые, некоторым видам рода вероника
    метёлка -- отличаются от двойных кистей более обильным ветвлением и тем, что нижние парциальные соцветия у них развиты и ветвятся гораздо сильнее верхних
        пирамидальная - сирень, бирючина, гортензия метельчатая
        щитковидная - калина, бузина, рябина
        кубковидная - лабазник
        зонтики -- метельчато ветвящееся, несущее на конечных осях простые зонтики - аралии высокая и маньчжурская
        корзинки -- метельчато разветвленное, несущее на конечных осях парциальные соцветия
        кисть корзинок - череда пониклая
        колос корзинок - сушеница лесная
    цимоиды -- с симподиальным нарастанием, в которых главная ось не выражена
        дихазиями -- каждая ось несёт две оси следующего порядка, дочерние оси здесь появляются в верхней части материнской и перерастают её верхушку
            ложный зонтик == многолучевой верхоцветник -- нижние участки осей (до прицветников) сильно укорочены - герань, костенец зонтичный
            корзинка -- полная редукции осей и скучивание большого числа дихазиев - короставник сивец ворсянковые
        монохазии -- каждая материнская ось несёт только одну дочернюю
            завиток -- от главной оси с единственным цветком отходит другая ось с единственным цветком, а от той — ось третьего порядка и так далее, при этом все цветки направлены в одну сторону - медуница
                двойные -- цветки третьего и более высоких порядков образуют монохазии - зверобой
            извилина -- цветки более высоких порядков возникают попеременно то справа, то слева по отношению к цветкам более низких порядков - бурачник, петуния
                двойные -- цветки первого и второго порядков располагаются в дихазиях - норичник незабудка окопник
        плейохазиями -- каждую материнскую ось сменяют несколько более или менее мутовчато расположенных дочерних, перерастающих её верхушку - некоторые виды лютика, бузина
        циаций == циатий -- из верхушечного пестичного цветка и пяти тычинок, возникших вследствие крайней редукции пяти тычиночных парциальных соцветий. окружен обёрткой, состоящей из прицветников опять-таки редуцированных парциальных соцветий - молочай
        тирс -- с моноподиально нарастающей главной осью и боковыми частными соцветиями-цимоидами - яснотковые бурачниковые норичниковые


гребінь -- скелет виноградного грона, що утворюється з осі суцвіття з усіма розгалуженнями
колоскові луски -- елементи оцвітини у суцвітті колос
зонтичный == дождниковый, растопыренный
