== залоза -- вырабатывающая вещества влиянія

внутренне выделения == эндокринные -- вырабатывают вещества (гормоны), не имея своих выводных протоков выделяют их в кровь
    щитовидная железа -- эндокринная железа у позвоночных, хранящая йод и вырабатывающая йодосодержащие гормоны
    вилочковая железа == тимус, зобная загруднинна железа -- выработка т-лимфоцит‎ов
    паращитовидные железы
    надпочечники == наднирник
    параганглии
    инкреторная часть поджелудочной железы
    гипоталамо-гипофизарная
        гипоталамус
        гипофиз
    эпифиз
внешние выделения == экзокринные -- вырабатывают вещества (секрет) и выводят их во внешнюю среду организма (человека или животных) или в его полости
    молочные == грудные -- парные внешней секреции у млекопитающих и отвечающие за выработку молока
        вымя -- член образованый молочными железами самок некоторых млекопитающих животных
    слюна -- прозрачная бесцветная жидкость, выделяемая в полость рта
    пот -- водный раствор солей и органических веществ, выделяемый потовыми железами
    слеза == слёзы -- жидкость, вырабатываемая слёзными желёзами для смачивания и очищения поверхности глаза у земноводных, пресмыкающихся, птиц и млекопитающих
    церуминозные -- трубчатые расположены у млекопитающих под кожей наружного слухового прохода и вырабатывают секрет, который при смешивании с кожным салом и мёртвыми клетками эпидермиса образует ушную серу
        ушная сера -- жёлто-коричневая смазкообразная секреция, вырабатываемая серными железами наружного слухового прохода в ушах людей и у других млекопитающих
    предста́тельная -- трубчато-альвеолярная мужского пола у млекопитающих
    сальные -- располагаются в коже у млекопитающих и выделяют жировой секрет — кожное сало (себум)
    бартолиновы == больши́е вестибуля́рные -- большие парные железы преддверия влагалища
    бульбоуретральные == куперовые -- две мелкие у мужчин, плотной консистенции, овальной формы
        предэякулят == предсемя, куперова жидкость -- прозрачная, бесцветная, вязкая предсеменная жидкость, которая выделяется из мочеиспускательного канала полового члена мужчины наружу, когда он приходит в состояние полового возбуждения
    железы желудочно-кишечного тракта -- выделяющие секрет в полость пищеварительного тракта
        желудочный сок -- почти бесцветная сильно кислая многокомпонентная жидкость в желудке
    печень == печінка
        жёлчь == жовч желчь -- жёлтая, коричневая или зеленоватая, очень горькая с запашком, выделяемая печенью и накапливаемая в жёлчном пузыре
    мокротиння == мокрота харкотиння -- секрет трахеобронхиального дерева, выделяющийся при кашле и отхаркивании с примесями секрета слизистой носа и слюны . является симптомом многих заболеваний респираторной системы
    слизь -- тягучее скользкое выделение в многоклеточных преимущественно из эпителиальной ткани слизистых оболочек
        носовая слизь -- слизь, выделяющаяся в носу
    вагинальный смазка == змащення -- секрет бесцветная жидкость, выделяющаяся у женщин при возбуждении

    чернильный мешок == чернильная железа -- вырост прямой кишки непарный защитный орган большинства головоногих моллюсков
    зобное молоко == птичье голубиное -- творожистый секрет, вырабатываемый у некоторых птиц для кормления птенцов

молозиво -- секрет молочной железы млекопитающих, вырабатываемый в последние дни беременности и в первые дни после родов

секрет == выделение -- внешнее вещество влиянія
испарина -- пот, выступающий на теле
