
козонки -- пястные и плюсневые кости (и фаланги)

руки
    рамено == плечо плещ -- отдел верхней конечности. оно располагается между плечевым поясом и предплечьем, и соединяется с ними посредством плечевого сустава и локтевого соответственно
    подмышка == пахва, подмышечная ямка -- место между верхними частями плеча и грудной клетки, находящаяся под плечевым суставом
    предплечье -- часть верхней конечности животного, ограниченная сверху локтевым суставом, а снизу -- запястьем
    кубитальная ямка == локтевая -- спереди над локтевым суставом и ограничивается тремя мышцами
    запястье -- отдел верхней конечности между костями предплечья и пястными костями (пястью), образованный восемью костями, соединяющая кости предплечья с пястью
    пясть -- кисть руки или ладонь с пальцами
    длань == ладонь долонь
    тыльная сторона ладони -- обратная ладони
ноги
    кайдышка == подколенная ямка -- часть задней области колена, его внутренний сгиб
    надколенник == коленная чашечка -- сесамовидная кость человека. располагается в толще сухожилия четырёхглавой мышцы бедра
    голень == глезно глезна, лодыжка, гомілка
    лодыжка == щиколотка кісточка гаджала -- костное образование дистального отдела голени
    голени == голяшки
    предплюсна == заплесно передплесно -- совокупность небольших костей стопы, заключённых между костями голени (больше- и малоберцовой) проксимально и костями плюсны -- дистально
    плюсна == ступня плесно -- средний отдел стопы у позвоночных, расположенный между предплюсной и пальцами
    хода == стопа
    пятка == пята -- выпуклая часть тела на задней стороне ступни. состоит из пяточной кости (calcaneus), расположенных на ней жировых тканей и кожи

хватальный хвост --  у животных приспособившийся к схватыванию или содержанию сущей
хвост -- член тела, располагающийся позади анального отверстия и не содержащий кишечника
хобот -- непарный вырост на переднем конце тела животного

лапа -- ступня либо вся конечность у некоторых млекопитающих
птичье крыло -- парная передняя конечность у птиц
ласт -- парная, как правило, плоская конечность, приспособленная для движения животного в воде и характерная для вторичноводных позвоночных животных

десница == правица, правиця, ворона -- правая дающая рука
шуица == шуйца сорока -- левая берущая рука, сорока тащит все к себе в гнездо
колыбель == левая рука кормящей матери
нога == нет га (пути движенія), песь
нага == на га путь
