
абстрактно == умозрительно отвлечённо теоретически -- руководствуясь созерцанием и теоретическим размышлением
абстрактный == отвлеченный
абстракция == отвлечение
анализ == разбирание
анализировать == обдумывать разбирать
анализы == измерения, замеры, исследования
аргумент == довод
воззрение == концепция -- образ мыслей, система взглядов на предмет, точка зрения
гипотеза == предположение
дедуктивный == выводимый, выводящий
дедукция == выведение -- заключение от общего к частному
замысел == задумка идея концепт -- изначальный замысел
знания -- осмысленая информация, с пониманием причинно-следственных связей
индуктивный == наводимый наводящий
индукция == наведение -- заключение от частного к общему
истина -- то, что существует в действительности, отражает действительность и проверенное опытом
логика == умословие
медитация == дума
метод == способъ, приёмъ
мироощущение -- отношение человека к окружающей действительности, природе, обществу, выражающееся в тех или иных настроениях, чувствах
мнимый -- воображаемый, существующий лишь в мысленном представлении людей
моделировать == воспроизводить -- создавать, изготовлять, представлять образец чего либо
модель == макет образец экземпляр воспроизводник представление -- пример разработки чи изделия в уменьшенном виде
мысль == думка -- определенная последовательность движений, обработки информации
намерение == наміръ -- предполагаемое действие
объект == сущь явление+предмет+тело+вещь -- элемент действительности, взятый без связи со временем; на кого направлены мысль и действие
объективный == непредвзятый, беспристрастный безсторонній
определение == термин -- конечное определение одного понятия (может быть несколько). действие, направленное на выявление смысла понятие
парадокс == противоречие -- явление, противоречащее обычным представлениям, не соответствующее естественным ожиданиям, возникающее при сохранении правильности хода рассуждений
план == продумка
планировка == застройка
понятие -- указывает смысл о предмете явлении. не существует без определения
понятийный == концептуальный
поползновение -- скрытое или не вполне определившееся намерение, желание, стремление что-либо сделать
постановка == сценарий
постановщик == сценарист режиссёр
предвзято == субъективно -- на основе заранее принятой точки зрения, без учёта объективных обстоятельств
предвзятость == субъективность -- сложившийся заранее и основанный на предубеждении
предполагать -- думать о чём-либо, допуская какую-либо возможность
предпосылка -- предварительное условие чего-либо
предрассудок -- ставший привычным ложный, суеверный взгляд на что-либо
проект == разработка
синтез == соединение єднання, поєднання, сполучення, обобщение, слияніе, слученіе -- создание нового путём объединения существовавших ранее
смета -- исчисление предстоящих расходов и доходов
смысл -- информационное содержание, совокупность значений чего-либо, постигаемых разумом
стереотип == предубеждение -- имеющееся изначально, заранее, предвзятое мнение, принятый в общности образец восприятия, основанный на предшествующем опыте других
стратегия == дальнодумие -- общий, не детализированный длительный план какой-либо деятельности
субъект == деятель -- тот, кто познаёт, мыслит и действует
суждение -- мысль, в которой утверждается наличие или отсутствие каких-либо положений дел
схема == набросок расчёртка
схематично == упрощённо
тактика == местодумие -- продуманая коротковременная составная часть стратегіи
тезис == утверждение -- положение, истинность которого должна быть доказана
трансцендентный == непознаваемый -- лежащий за пределами опыта, недоступный опытному познанию
умозаключение -- выведения заключения из суждений, основанных на рассуждении, размышлении
умозрение == теория -- разработаная совокупность взаимосвязанных утверждений, которая описывает некоторую предметную область, для обоснования существующих явлений и данных
умозрительный == теоретический -- проделанный в уме, не опробованный на деле
эверетт роджерс диффузия инноваций
эскиз == чертёж креслення -- условное, выполненное по установленным правилам изображение на плоскости
этюд == предпроизведение -- произведение (рисунок картина скульптура), как часть будущего большого произведения
тема == вопрос
тематика == направленность -- совокупность, круг вопросов
