
волосы -- придатки кожи, производные из эпидермиса, многослойные нитеообразные структуры из эпителиальных клеток ороговевающих по мере удаления из точки роста в волосяных фолликулах и образующих наружный покров кожи млекопитающих
гребіень -- довгастий зубчастий м'ясистий наріст на голові деяких птахів,
грива -- длинные волосы, покрывающие шею и спину некоторых млекопитающих, также называют гривой длинные густые волосы у человека
мех == хутро -- густий дрібний волосяний покрив звірів
оперение -- перьевой покров птиц
пух -- мягкие птичьи перья с мягким стержнем и слабым развитием опахала, находящиеся под более жестким внешним перьем
чешуя == луска -- наружный покров некоторых живосущей, образуемый роговыми (у амниот) или костными (у рыб) пластинками
шерсть -- волосяной покров млекопитающих
щетина == жёсткая короткая шерсть из утолщенных волос на теле некоторых животных
длак == шкура, шерсть, волоссы
наседное пятно -- у птиц неоперённый участок кожи тела с развитыми кровеносными сосудами
панцирь -- твердое защитное образование, иногда подвижное, полностью или частично покрывающее тело некоторых животных
перо -- накожное роговое образование птиц, а также некоторых нептичьих динозавров
иглы -- сильно развитые, утолщённые и твёрдые волосы (млекопитающие); роговые выросты чешуек и щитков (пресмыкающиеся рыбы)
шуба -- густой покров шерсти у животных

клюв == дзьоб -- член образованный челюстями (обычно удлинёнными и беззубыми), одетыми роговым чехлом
жало -- заострённый орган для впрыскивания ядовитого или жгучего вещества под кожу жертвы или для нанесения молноудара
ногти -- придатки кожи в виде плотных роговых пластинок на тыльной поверхности концов пальцев верхних и нижних конечностей приматов
панты -- рога оленей в период их ежегодного роста, имеют трубчатую неороговевшую структуру, наполнены кровью, покрыты тонкой бархатистой кожей с короткой мягкой шерстью
клешни == клішня -- хватательные органы, которыми оканчиваются ноги, челюсти или усики (сяжки) некоторых членистоногих
коготь == пазур
копито == ратиця -- рогове утворення на кінцях пальців у ссавців низки парнокопитних та непарнокопитних
бивень -- збільшений та видовжений зуб деяких видів ссавців, що виглядає із закритого рота
рог -- тверде скостеніле або рогове утворення на черепі деяких ссавців
китовый ус -- роговые пластины у усатых китов, свисающие с нёба, которые служат для отсеивания планктона
щупальца -- подвижные выросты тела у представителей многих групп беспозвоночных животных и некоторых позвоночных
присоска -- член для прикрепления к твёрдым поверхностям

кутикула -- образование, лежащее поверх эпителиального слоя у многих беспозвоночных
перепонка -- кожа между пальцами у животных, передвигающихся в водной среде
гольё -- дерма шкуры животного, свободная от волосяного покрова, эпидермиса, мездры и посторонних веществ
дерма == кориум кутис -- кожа, соединительнотканная часть кожи у позвоночных, расположенная между эпидермисом и нижележащими органам
кожа == шкіра -- наружный покров тела животных
эпидермис == кожица -- наружный многослойный слой из эпителия кожи
эпителий == -- ткань из клеток, плотно расположенных друг возле друга, межклеточного вещества мало эпидермис, образует полости тела, слизистые оболочки внутренних органов, пищеварительной дыхательной мочеполовой систем, образует большинство желез организма
фасция -- соединительнотканная оболочка, покрывающая органы, сосуды, нервы и образующая футляры для мышц у позвоночных; выполняет опорную и трофическую функции
перламутр == баламут, мать жемчуга -- внутренний слой раковин, обволакивающее песчинку вещество в жемчужнице

линька == линяння -- процесс смены и восстановления покровов животных
