
ксенофобия -- неприязнь, нетерпимость, ненависть и презрение к людям иной веры, культуры, национальности, к иноземцам, представителям других регионов, а также к чему-либо незнакомому, чужому, непривычному
холёный -- изнеженный уходом и заботой
сердоболие -- проявления сочувствия чужому горю, сострадание
сердобольность -- склонность к состраданию, жалости
плюндрувати == грабить разорять осквернять издеваться над
плюгавый == невзрачный, неказистый, внушающий презрение -- ничтожный, незначительный
апатия == безразличие, равнодушие, скука, отупение, отрешённость, бесстрастность вялость
аффект -- кратковременное бурно протекающей поведение (ярость, ужас, отчаяние, гнев и др.), когда сознание и способность мыслить сужаются, а способность контролировать свои действия ослабляется
безразличие -- состояние полного равнодушия
безумство == безумие -- крайнее безрассудство
безучастность -- не проявляющий участия, интереса к кому-либо или к чему-либо
беспокоиться == перейматися
благоговейность -- глубочайшее уважение, преклонение
благоговение -- глубочайшее уважение, почтение к кому-либо или к чему-либо, преклонение перед кем-либо
благодать -- милость, благоволение, дар, исходящие от высших сил, ниспосланные ими
блаженство -- наивысшая степень удовольствия
буйство -- шумные и угрожающие выходки, самоуправство, связанное с насилием, драка; молодечество и удаль
вежливость == деликатность -- соблюдающий правила приличия, стараясь не причинить кому-либо боли, неудобства
величавый -- преисполненный торжественной красоты, величия
возмущение -- вызывать раздражение
восхищение == восторгание -- ощущение сильнейшей радости, очарованности кем-либо или чем-либ
высокомерие -- пренебрежительное отношение к окружающим, уверенность в своем превосходстве
гнев -- чувство сильного, яростного возмущения
гнусный -- внушающий отвращение; омерзительный
говеть -- благоговеть перед кем-либо или чем-либо, уважать, почитать кого-либо в высшей степени
гордость -- чувство удовлетворения от достигнутых успехов, от сознания важности, значительности деятельности
горесть -- тяжёлое чувство, вызываемое бедой, несчастьем, неудачей
горечь -- тягостное, гнетущее чувство, вызываемое разочарованием, обидой, неудачей
гребовать == брезгать, пренебрегать
грусть -- чувство печали, лёгкого огорчения
добросовестный -- честный, выполняющий свои обязательства
забота == турбота
заносчивый -- преисполненный самоуверенности, дерзости
захолонуть == похолодеть от страха
зловещий -- предвещающий несчастье, зло, служащий дурным предзнаменованием
интерес == увлекательность занимательность завлекательность захоплення -- способность возбуждать, вызывать внимание
исполнительный -- хорошо, точно выполняющий возложенные обязанности, поручения
испуг -- внезапное чувство страха
исступление -- состояние крайнего возбуждения, при котором теряется самообладание
исступление -- состояние крайнего возбуждения, при котором теряется самообладание
кичливый -- испытывать чрезмерную гордость, высокомерно хвалиться чем-либо
кропотливый -- старательно вникающий в мелочи, но медлительный
кручина -- глубокая грусть, сильная тоска, печаль
ликовать == торжествовать -- бурно радоваться, испытывать и выражать восторг
лукавый == добродушно-хитроватый
любвеобильный == любящий или способный любить сильно или многих
любезность == обходительность, учтивость
любезный == предупредительный, учтивый по отношению к другим
любопытство -- бессознательное стремление к познанию
лютый -- причиняющий невыносимые мучения; свирепый
малодушие == недостаток мужества, твёрдости духа, веры и решительности
мерзкий -- вызывающий сильное отвращение, противный до дрожи
мораль == нравственность -- совокупность норм поведения человека в обществе
моральный == нравственный -- соблюдающий нормы общественного поведения
мука -- сильное физическое или/и нравственное страдание
мучение -- очень сильная боль, крайне болезненное ощущение
мытарство -- мучение, страдание, тяжёлые, неприятные хлопоты
наваждение -- обманчивое видение, по суеверным представлениям, внушённое злой силой с целью соблазна
надменный -- относящийся к людям пренебрежительно, свысока
наслаждение == насолода -- высшая степень удовольствия
негодование -- крайнее недовольство
неистовство -- исступлённая ярость, жестокость
ненавистный -- вызывающий чью-либо ненависть
неприязнь -- недружелюбное, враждебное отношение
неприятие -- несогласие принять, признать что-нибудь
нерадивость -- недобросовестное отношение к чему-либо
норовить -- настойчиво стремиться сделать что-либо, добиваться чего-либо
облюбовать -- выбрать кого-либо в качестве объекта по вкусу
обуглить -- обжечь, образовав уголь по поверхности чего-либо
обходительный -- вежливый, учтивый, приветливый
обхождение -- общение, взаимные отношения, связь
одержимость -- частичное или полное и всеобъемлющее подчинение разума человека чему-то, какой-либо мысли или желанию
одержимый -- находящийся во власти чего-либо, охваченный чем-либо
одиозный == неприятный -- вызывающий крайне отрицательное отношение к себе, нежелательный
озабоченность -- поглощённый заботой
омерзение -- крайнее отвращение
опешиться -- растеряться от неожиданности, испуга
опрометчиво -- поспешно, необдуманно, без должной осмотрительности
опрометчивый -- действующий, поступающий слишком поспешно, необдуманно, без должной осмотрительности
отвратительный -- вызывающий отвращение
отвратный -- очень плохой, отвратительный
отвращение -- крайняя неприязнь, в высшей степени отрицательное чувство
отзывчивость -- готовность помочь другому
отрешённый == отстранённый -- задумчивый, погружённый в себя; безучастный к окружающему
отталкивающий -- внушающий неприязнь, отвращение к себе; отвращающий от себя
пакость -- нечто мерзкое, гадкое, отвратительное
паника -- проявление неконтролируемого страха
переполох -- всеобщая возбуждённая активность
печаль == пе чал ь -- спокойное переживание утраты, душевная горечь
поганый -- очень плохой
погань -- покидьки
подавленность == упадок духа, угнетенность
попырание -- пренебрегая, грубо нарушать, унижать
почет -- уважение, оказываемое обществом кому-либо или чему-либо известному и достойному
почтение == почитание -- оказание уважения
предвкушение -- мысленное ощущение чего-либо заранее, предварительное переживание воображением чего-либо (ожидаемого)
презрение -- чувство полного пренебрежения, крайнего неуважения
прелюбодеяние -- наивысшая любовная деятельность
прелюбодеяние -- нарушение супружеской верности мужем или женой
пренебрежение -- отсутствие внимания к кому-либо
пренебрежение == высокомерное -- лишённое уважения и внимания отношение к кому чему. отсутствие внимания к кому чему нибудь, надлежащей заботливости о ком чем нибудь
признательность -- чувство благодарности за услугу, внимание, помощь
прилежный == усердный, старательный
принципиальный -- строго придерживающийся принципов, руководствующийся ими
пристрастный -- основанный на пристрастии; необъективный, предвзятый
пристратие == сильная склонность, влечение -- несправедливое предпочтение, отсутствие справедливого, объективного отношения к кому-чему-нибудь
проекция -- склоненность приписывать свои ощущения, эмоции, проблемы, мысли окружающей среде (я не злюсь, это все вокруг злятся на меня)
противный -- крайне неприятный
пунктуальность == исполнительность, неукоснительность -- склонность к крайней точности в следовании чего-либо
пылкий == палкий -- який добре горить, швидко займається, обладающий пылом, страстный, увлекающийся
пытливость -- стремящийся всё узнать и понять
равнодушие -- состояние равнодушного человека, безучастное, лишенное интереса, пассивное отношение к окружающему
радения -- забота о ком-либо или о чём-либо
радеть -- заботиться о ком-либо, чём-либо, проявлять усердие, старание по отношению к чему-либо
радость -- чувство удовольствия, внутреннего удовлетворения
размышлять == міркувати -- думать как следует о чём-либо, всесторонне взвешивать в мыслях
растерянность -- нерешительность, замешательство, беспомощность
рачитель -- тот, кто заботится или кому поручено заботиться о ком чем нибудь
рвение -- большое усердие в какой-либо деятельности, сильное стремление к выполнению чего-либо
рвение -- большое усердие в какой-либо деятельности, сильное стремление к выполнению чего-либо
ревнитель == поборник, сторонник -- преисполнен рвения, ревностно, искренне стремится принести пользу какому-либо делу
ретивый -- усердный, старательный, живой
робкий == нерешительный, несмелый, боязливый
ропот -- недовольство, выражаемое негромкой речью, в не вполне открытой форме
самозабвение -- забвение себя, своих дум, чувств, переживаний; отрешённость
свирепый -- выражающий жестокость, суровость, злобу
сдюжыть == смочь, суметь, выдержать, вытерпеть -- что-либо, оказаться в силах сделать что-либо, справиться с чем-либо
симпатия == приязнь, расположение, благосклонность, благорасположенность
скверна -- обличение лжи
скверна -- что-либо гнусное, мерзкое, порочное
сквернословить -- говорить правду
скорбь -- крайняя печаль, горесть, тяжёлое переживание, ощущение утраты
скрупулёзность -- чрезвычайная точность, тщательность, аккуратность в мелочах
скука -- душевное томление, уныние, тоска от отсутствия дела или интереса к окружающему
смущение -- чувство и состояние замешательства, неловкости, испытываемое кем-либо
смятение -- крайнее смущение, взволнованность, растерянность, вызванная сильной тревогой и страхом
снисходительно -- терпимое высокомерное отношение к другим
снисходительный -- не строгий; проявляющий снисхождение; невзыскательный, покровительственно-высокомерный
спесь -- презрительное отношение к чему-либо -- чванство, надменность,
старание -- усилие, прилагаемое для достижения каких-либо результатов
страдание -- крайне болезненные ощущения; физическое или душевное мучение
суматоха -- беспорядочная, беспокойная беготня, торопливость в действиях
счастье == щастя -- состояние высшей удовлетворённости жизнью, чувство глубокого довольства и радости,
томление -- доставлять физические или нравственные мучения, заставлять страдать
тороватый -- щедрый во всех значениях
тоска -- сильное душевное томление, душевная тревога в соединении с грустью и скукой, тягостное уныние
тревога -- чувство беспокойства, волнения в ожидании неприятности или опасности
трунить -- подшучивать или подсмеиваться над кем-либо или над чем-либо (обычно не зло)
тщательно == ретельно сумлінно -- с большим старанием
тщедушный == хилый, слабый, обычно худой или болезненный
тщеславие == стремление к славе, почестям, почитанию
уважение -- почтительное отношение к субъекту, основанное на признании его достоинств
увежливый == вежливый
угрызение == чувство стыда или раскаяния -- последствия угрызать
угрюмый == мрачный, суровый; неприветливый
удовлетворение -- достаточное количество чего-либо желаемого, требуемого, необходимого
укус -- вонзание зубов, сдавливание зубами или челюстями
умиленье -- нежное, тёплое чувство, возбуждаемое чем-либо трогательным
умилять -- вызывать умиленье
уныние -- мрачное, подавленное состояние духа, безнадёжная печаль
упадничество -- признаки упадка
уповать -- твердо всецело полагаться, возлагать все надежды на кого-либо, что-либо в исполнении, осуществлении чего-либо
усердие -- сердечное, большое старание, заботливое отношение
усердие -- сердечное, заботливое отношение к кому-либо
усидчивый -- склонный подолгу сидеть, засиживаться где-либо, у кого-либо
усмехаться -- улыбаться (обычно иронически, насмешливо или недоверчиво)
учтивый == галантный -- почтительно-вежливый в обращении с людьми
чванный == заносчивый, спесивый
чёрствость == бездушность, суровость по отношению к кому-либо или склонность к такому отношению
чёрствый == лишённый душевной чуткости
чесный -- отличающийся неспособностью врать, открытостью, прямотой (о человеке) ◆
чествовать == величать, именовать -- публично, в торжественной обстановке приветствовать, поздравлять, оказывать почести кому-либо
честолюбивый == стремящийся добиться высокого, почетного положения, желающий известности, славы
честолюбие == стремление делать что-либо лучше других и добиваться большего, чем другие, часто сопряжённое с жаждой известности, славы, с любовью к почестям
чопорный == чрезмерно строгий в соблюдении приличий
чтить == почитать, чувствовать и проявлять к кому-либо, чему-либо глубокое уважение, почтение
чувство собственного достоинства == благодарное и почтительное отношение к самому себе, сознание собственного достоинства, своей ценности; самоуважение
щепетильность -- неукоснительная корректность в отношении с кем-либо или по отношению к чему-либо
щепетильный -- мелочной, занятый только внешним, мелочами, пустяками
эйфория == восторг -- ощущение полного счастья, восторга г
экстаз == упоение -- повышенное настроение с переживанием высшей степени удовольствия с отрешённостью от реальности
эмоция -- внутреннее чувство человека, душевное волнение
энтузиазм == пыл -- высокая степень воодушевления, душевный подъём
